Tootsie.	#Dustin Hoffman, Jessica Lange, Teri Garr,...	#Alan Grint	#Todos los públicos
Diez negritos.	#Oliver Reed, Elke Sommer, Richard Attemborough,...	#Abbas Kirostami	#No recomendado a menores de 13 años
Volver a casa.	#Joely Richardson, Gary Oldman, Stephen Dillane,...	#Alan Parker.	#No recomendado a menores de 13 años
Las aventuras de Pinocho.	#Martin Landau, Jonathan Taylor Thomas....	#Albert y Allen Hughes.	#Sin clasificar
Dinosaurios.	#Omri Katz, Shawn Hoffman, Tiffanie Poston,...	#Bernard Rose.	#Todos los públicos
Gaby, una historia verdadera.	#Rachel Levin, Liv Ullman, Norma Aleandro,...	#Alan Parker.	#Todos los públicos
Anna Karenina.	#Sophie Marceau, Sean Bean, Alfred Molina,...	#Alan Parker.	#No recomendado a menores de 13 años
Aventuras en la corte del rey Arturo.	#Thomas Ian Nicholas, Joss Ackland, Art Malik,...	#Bernard Rose.	#Todos los públicos
Mohawk.	#Scott Brady, Rita Gam, Neville Brand, ...	#Al Waxman.	#Todos los públicos
Dos tontos muy tontos.	#Jim Carrey, Jeff Daniels, Lauren Holly,...	#Alan Grint	#Todos los públicos
Starlight.	#Kario Salem, Jean Taylor, Pamela, Payton-Wright 	#Alex Cox.	#Todos los públicos
Espías sin fronteras.	#Gene Hackman, Mikhail Barisnikhov, Kurtwood Smith.	#Abbas Kirostami	#No recomendado a menores de 13 años
Bwana.	#Andrés Pajares, María Barranco, Emilio Buale.	#Alan Parker.	#No recomendado a menores de 13 años
A por el oro.	#James Ryan, Mzwandile Ngxangane, Sandra Horne, Cameron Mitchell	#Albert y Allen Hughes.	#Todos los públicos
Austin Powers	#Mike Myers, Elizabeth Hurley, Michael York, Mimi Rogers.	#Alan Grint	#Todos los públicos
La red.	#Sandra Bullock, Jeremy Northam, Dennis Miller, Diane Baker	#Abbas Kirostami	#No recomendado a menores de 13 años
Tensa espera.	#Susan Sarandon, Sam Shepard, Sean Astin, Robert Sean Leonard	#Alan Parker.	#No recomendado a menores de 13 años
Hairspray.	#Sonny Bono, Ruth Brown, Mabel Divine, Colleen Fitzpatrick	#Alan Grint	#No recomendado a menores de 13 años
Un verano junto al mar.	#Kerstin Draeger, Heikko Deutschmann, Ruth María...	#Alan Parker.	#Todos los públicos
Su juguete preferido.	#Richard Pryor, Jackie Gleason.	#Alan Grint	#Todos los públicos
Vaya par de idiotas.	#Woody Harrelson, Randy Quaid, Bill Murray,....	#Alan Grint	#Todos los públicos
Dos por el precio de una.	#Kirstie Alley, Steve Guttenberg, Mary K. Olsen,...	#Alan Grint	#Todos los públicos
Un loco a domicilio.	#Jim Carrey, Matthrew Broderick, George Segal,...	#Alan Grint	#Sin clasificar
Star Trek.	#William Shatner, Leonard Nimoy,...	#Alfonso Ungría	#Todos los públicos
Misión imposible.	#Peter Graves, Barbara Bain,...	#Alex de la Iglesia.	#Todos los públicos
Rosa Rosae	#Ana Bélen, María Barranco, Juanjo Puigcorbe,...	#Alan Grint	#Sin clasificar
A galope	#R. G. Armstrong, Lloyd Bridges, Lonny Chapman, Pat Hingle.	#Alan Parker.	#Todos los públicos
Velocidad terminal	#Charlie Sheen, Natassja Kinski, ....	#Barry Sonnenfeld.	#Sin clasificar
Hellbound: Hellraiser II.	#Clare Higgins, Ashley Laurence,....	#Betty Kaplan.	#Sin clasificar
El fantasma de la  ópera.	#Maximiliam Schell, Jane Seymour,...	#Alan Parker.	#Sin clasificar
Doble venganza.	#Leigh McCloskey, Joe Dallesandro,...	#Bernard Rose.	#Sin clasificar
Halcones de mar.	#Rob Lowe, Gale Hansen, Tracy Griffith,...	#Alan Parker.	#Sin clasificar
Un casino en el espacio.	#Matthew Barton, Jennifer Blowdryer, John Canalli,-	#Alan Birkinshaw.	#Sin clasificar
Dos días en el valle.	#Danny Aiello, Greg Cruttwell, ...	#Abbas Kirostami	#Sin clasificar
Creepshow.	#Hal Holbrood, Leslie Nielsen, Ed Harris,...	#Betty Kaplan.	#Sin clasificar
Estoy vivo.	#John P. Ryan, Sharon Farrell, James Dixon,...	#Betty Kaplan.	#Sin clasificar
Syngenor, el soldado del futuro.	#Starr Andreeft, Lewis Arquette, ...	#Alan Birkinshaw.	#Sin clasificar
Doce del patíbulo.	#Lee Marvin, Charles Bronson, Telly Savalas,...	#Billy Wilder.	#Sin clasificar
Secuestrada.	#Goldie Hawn, John Heard, Ashley Peldon,...	#Abbas Kirostami	#Sin clasificar
El dentista.	#Corbin Bernsen, Linda Hoffman, Molly Hagan,...	#Albert y Allen Hughes.	#Sin clasificar
Henry: retrato de un asesino.	#Michael Rooker, Tom Towles, Tracy Arnold,...	#Abbas Kirostami	#Sin clasificar
Warlock, el brujo.	#Julian Sands, Lori Singer, Richard E, Grant,...	#Betty Kaplan.	#Sin clasificar
Han llegado.	#Charlie Sheen, Lindsay Crouse, Roichard Schiff,...	#Alan Birkinshaw.	#Sin clasificar
Angel of desire.	#Melanie Hudson, Nathan Leonard.	#Barry Sonnenfeld.	#No recomendado a menores de 18 años
Tiburón: La venganza	#Lance Guest, Mario Van Peebles, Karen Young.	#Alan Parker.	#No recomendado a menores de 13 años
El corazón del ángel.	#Mickey Rourke, Robert De Niro, Lisa Bonet.	#Betty Kaplan.	#No recomendado a menores de 18 años
Highlander.	#Christopher Lambert, Sean Connery, Roxanne Hart.	#Barry Sonnenfeld.	#No recomendado a menores de 13 años
Montaña rusa.	#George Segal, Richard Widmark,Henry Fonda.	#Abbas Kirostami	#No recomendado a menores de 7 años
Frankenstein.	#Boris Karloff, Colin Clive, Mae Clarks.	#Betty Kaplan.	#No recomendado a menores de 7 años
Creemos en el amor.	#Clifton Webb, Dorothy Mcguire, Jean Peters; Louis jourdan, Maggie Mcnamara, Rossano Brazzi.	#Alan Parker.	#Todos los públicos
El coleccionista	#Terence Stamp, Samantha Eggar, Maurice Dellimore.	#Abbas Kirostami	#No recomendado a menores de 13 años
Un verano para matar	#Christopher Mitchum, Karl Malden, Olivia Hussey, Raf Vallone, Claudine Anger	#Abbas Kirostami	#No recomendado a menores de 13 años
A través de los olivos.	#Mohamad Ali Keshavarz, Farhad Khradmand, Zarifeh Shiva, Hossein Rezai.	#Alan Parker.	#No recomendado a menores de 13 años
El contrato del dibujante.	#Anthony Higgins, Janet Suzman, Anne Louise Lambert.	#Alan J. Levi.	#No recomendado a menores de 13 años
El día de las idiotas	#Carole Bouquet, Ingrid Caven, Ida Di Benedetto, Tamara Kafka	#Alan Parker.	#Sin clasificar
Vertical features remakes.	#Música: Michael Nyman.	#Alan J. Levi.	#No recomendado a menores de 13 años
Un hombre llamado Peter	#Richard Todd, Jean Peters, Robert Burton, Marjorie Rambeau, Jill Esmond, Mimi Hutson	#Alan Parker.	#No recomendado a menores de 13 años
Vanya en la calle 42.	#Wallace Shawn, Brooke Smith, Julianne Moore, George Gaynes, André Gregory.	#Alan Parker.	#Todos los públicos
Estrella de fuego	#Elvis Presley, Bárbara Edén, Dolores del Río, Steve Forrest	#Al Waxman.	#No recomendado a menores de 13 años
El espía que surgió del frío	#Richard Burton, Oskar Werner, Anne Blake, Claire Bloom	#Abbas Kirostami	#No recomendado a menores de 13 años
El diablo dijo no	#Don Ameche, Gene Tierney, Charles Coburn, Laird Cregar	#Alan Grint	#Todos los públicos
París, France	#Leslie Hope, Peter Outerbridge, Victor Ertmanis, Dan Lett, Raoul Trujillo, Patricia Ciccoritti.	#Albert Brooks.	#No recomendado a menores de 18 años
Ladybird, Ladybird.	#Crissy Rock, Vladimir Vega, Sandy Lavelle, Mauricio Venecas.	#Alan Parker.	#No recomendado a menores de 18 años
Callejón sin salida	#Humphrey Bogart, Lizabeth Scott, Morris Carnovsky, Charles Cane.	#Abbas Kirostami	#Sin clasificar
Un día de boda 	#Desi  Arnaz  Jr., Carol Burnett, Mia Farrow, Geraldine Chaplin	#Alan Grint	#No recomendado a menores de 13 años
Un, Dos, Tres Al Escondite Inglés	#Patti Shepard, Judy Stephen, Tina Sainz.	#Alan Grint	#Todos los públicos
Otelo	#Orson Welles, Suzanne Cloutier, Robert Coote, Michael MacLiammoir. 	#Alan Parker.	#No recomendado a menores de 13 años
Dos veces mujer.	#Bibi Andersson, Sandrine Dumas, Anthony Perkins, Charles Gormley.	#Alan Parker.	#No recomendado a menores de 18 años
El escándalo Larry Flint	#Woody Harrelson, Courtney Love, Edward Norton, James Cromwell.	#Alan Parker.	#No recomendado a menores de 18 años
Café Irlandés	#Colm Meaney, Tina Kelleguer, Ruth McCabe.	#André de Toth	#No recomendado a menores de 13 años
Sabrina.	#Humphrey Bogart, Audrey Hepburn, William Holden, John Williams.	#Alan Grint	#Todos los públicos
Sangre fácil.	#Frances McDormand, John Getz, Dan Hedaya, Deborah Newman.	#Abbas Kirostami	#No recomendado a menores de 18 años
Gary Cooper que estas en los cielos.	#Mercedes Samprieto, Jon Finch, Carmen Maura, Agustín Gonzalez.	#Alan Parker.	#Sin clasificar
Días contados.	#Carmelo Gómez, Ruth Gabriel, Candela Peña, Javier Bardem, Elvira Mínguez, Karra Elejalde.	#Alan Parker.	#Sin clasificar
Shakespeare in love (Shakespeare enamorado)	#GWYNETH PALTROW, JOSEPH FIENNES, GEOFFREY RUSH, 	#Alan Myerson.	#Todos los públicos
Babe: el cerdito en la ciudad.	#Magda Szubanski, James Cromwell, Mary Stein, ...	#Alan Grint	#Todos los públicos
Ciudadano Kane	#Orson Welles, Joseph Cotten, Dorothy Comingore, Agnes Moorehead	#Alan Parker.	#No recomendado a menores de 18 años
Un pueblo llamado Dante´s Peak	#Pierce Brosnan, Linda Hamilton y Jeremy Foley	#Barry Sonnenfeld.	#No recomendado a menores de 7 años
Doña Bárbara	#Esther Goris, Jorge Perugorría, Ruth Gabriel.	#Alan Parker.	#No recomendado a menores de 13 años
Dos pájaros a tiro.	#Mel Gibson, Goldie Hawn y David Carradine	#Alan Grint	#Todos los públicos
Tiburón	#Roy Scheider, Robert Shaw y Richard Dreyfuss	#Abbas Kirostami	#No recomendado a menores de 13 años
Strike force	#Richard Gere, Cliff Gorman, Don Blakely, Joe Spinell	#Alan Parker.	#No recomendado a menores de 13 años
El día de la bestia	#Alex Angulo, Santiago Segura y Terele Pávez.	#Betty Kaplan.	#Sin clasificar
Chicago	#Tyrone Power, Aliced Faye, Don Ameche...	#Alan Parker.	#Todos los públicos
Satanik.	#Magda Konopka, Armando Calvo, Umberto Raho.	#Betty Kaplan.	#No recomendado a menores de 18 años
Un final muy feliz.	#Leaf Phoenix, John Aprea.	#Alex de la Iglesia.	#Sin clasificar
Terminator	#Arnold Schwarzenegger, Michael Biehn, Linda Hamilton	#Alan Birkinshaw.	#Sin clasificar
Fahrenheit 451	#Julie Christie, Oskar Werner, Anton Diffring	#Alan Birkinshaw.	#No recomendado a menores de 7 años
Nacido el 4 de julio.	#Tom Cruise, Kyra Sedgewich, Willem Dafoe.	#Billy Wilder.	#No recomendado a menores de 13 años
Habana	#Robert Redford, Lena Olin, Alan Arkin	#Alan Parker.	#No recomendado a menores de 7 años
Tarántula.	#John Agar, Leo G. Carrol.	#Alan Birkinshaw.	#Sin clasificar
Saturday night fever.	#John Travolta, Karen Lynn Gorney, Barry Miller, Joseph Cali, Paul Pape, Donna Pescow.	#Alex Cox.	#No recomendado a menores de 13 años
Música y lágrimas	#James Steward, June Allyson, Harry Morgan	#Alan Parker.	#Todos los públicos
Un yanqui en la corte del Rey Arturo	#Bring Crosby, Rhonda Fleming, William Bendix	#Alan Grint	#Todos los públicos
Missouri.	#Marlon Brandon, Jack Nicholson, Rendy Quaid,..	#Al Waxman.	#No recomendado a menores de 13 años